NO ./textures/NO.png
SO ./textures/SO.png
WE ./textures/WE.png
EA ./textures/EA.png

F 237, 201, 175
C 173, 216, 230

111111
1N0001
111111
