NO ./textures/NO_test.png
SO ./textures/SO_test.png
WE ./textures/WE_test.png
EA ./textures/EA_test.png

F 220,100,0
C 225,30,0

        1111111111111111111111111
        1000000001110000000000001 
        1011000001110000000000001
        1001000000000000000000001
111111111011000001110000000000001
100N00000010000001110111111011111
11110111111111011100000010001
11110111111111011101010010001
11000000110101011100000010001
10000000000000001100000010001
10000000000000001101010010001
110000011101010111101111000111  
11110111 1110101 101111010001
11111111 1111111 111111111111

